0000000000000000000000000000000000000000
0000000000000000000000000000000000000000
0000000000000000000000000000000000000000
0000000000000000000000000000000000000000
0000000000444444000000000044444400000000
0000000004400000440000000440000044000000
0000000040000000040000044000000004000000
0000000040000000004400040000000000400000
0000000400000000000400400000000000400000
0000000400000000000040400000000000040000
0000004000000000000044000000000000040000
0000000400000000000004000000000000004000
0000004000000000000000000000000000040000
0000000400000000000000000000000000004000
0000004000000000000000000000000000040000
0000000400000000000000000000000000004000
0000000400000000000000000000000000040000
0000000400000000000000000000000000040000
0000000400000000000000000000000000400000
0000000040000000000000000000000000400000
0000000040000000000000000000000004000000
0000000004000000000000000000000044000000
0000000004000000000000000000000440000000
0000000000440000000000000000000400000000
0000000000040000000000000000044000000000
0000000000004000000000000000040000000000
0000000000004000000000000000400000000000
0000000000000440000000000000400000000000
0000000000000040000000000004000000000000
0000000000000004400000000004000000000000
0000000000000000400000000440000000000000
0000000000000000044000004400000000000000
0000000000000000004000040000000000000000
0000000000000000000440440000000000000000
0000000000000000000044000000000000000000
