1111111110000111111111000000011111011111
1111111000000111110000000000111111111111
1110100000000000000000000000111111111111
1110000000000000000000000000000011111111
1100000000000000000011110000000011110000
1100000000000000000011110000000011100000
1111100000000000000111111110011111000000
1111111110000111111111111111111100000000
1111111111111111111111111111000000000000
1111111000000011111111111111100000000000
1111100000000001111111111111110000000000
1110000000000001111111111111111000000000
1110000000000000111111111111111000000000
1110000000000000111111111111111000000000
1110000000000000111111111111111000000000
1110000000000001111111111111111000000000
1111000000000011111111111111111111000000
1111111000001111111111111111111111110000
1111111111111111111111111111111111111100
1111111111111111111111111111111111111111
1111111111111111111111111111111111111111
1111111111111111111111111111111111111111
1111111111111111111111111111111111111111
1111111111111111111111111111111111111111
1111111111111111111111111111111111111111
1111111111111111111111111111111111111111
1111111111111111111111111111111111111111
1111111111111111111111100000000000111111
1111111111111111111110000000000000000111
1111100001111111110000000000000000000001
1100000000001110000000000000000000000000
0000000000000000000000000000000000000000
0000000000000000000000000000000000000000
0000000000000000000000000000000000000000
0000000000000000000000000000000000000000
