1
2
#
#
#
#
#
#
#
#
#
#
#
#
#
#
#
#
#
#
#
#
#
#
#
#
#
#
#
#
*2,2:Ugarit:archer:10

*13,3:Ekron:swordsman:10

*23,4:Qumran:swordsman:10

*23,12:Masat Hoyuk:wolf:10

*13,13:Lachish:dragon:10

*13,14:Qatara:white mage:10

*3,15:Tepe Gawra:wolf:10

*3,23:Shibaniba:swordsman:10

*13,24:Babilim::10

*24,25:Kedesh:archer:10

@23,4:2
@3,23:1
