1
2
#
#
#
#
#
#
#
#
#
#
#
#
#
#
#
#ÅÅ
#Å
#ÅÅ
#ÅÅ
#Å
#
#Å
#
#
#
#
#
#
#
#
#
#
#
#
#
#
#
#
#
#
#
#
#
*8,10:Ugarit:archer:10

*19,11:Ekron:swordsman:10

*29,12:Qumran:swordsman:10

*29,20:Masat Hoyuk:wolf:10

*19,21:Lachish:dragon:10

*19,22:Qatara:white mage:10

*9,23:Tepe Gawra:wolf:10

*9,31:Shibaniba:swordsman:10

*19,32:Babilim::10

*30,33:Kedesh:archer:10

@26,25:2
@9,31:1
