1
#
#
#
#
#
#
#A
#
#
#
#
#
#
#
#
#
#
#
#
#
#
#!
#
#
#
#
#
#
*17,1:Bethany:swordsman:10
*18,1:Nabada:swordsman:10
*2,2:Ugarit:archer:10
*18,2:Gath:swordsman:10
*13,3:Ekron:swordsman:10

*23,6:Qumran:swordsman:10

*13,13:Lachish:dragon:10
*13,14:Qatara:dragon:10

*23,14:Masat Hoyuk:archer:10

*3,15:Tepe Gawra:archer:10

*3,21:Shibaniba:swordsman:10

*13,24:Babilim::10

*8,25:Nippur:swordsman:10
*24,25:Kedesh:archer:10
*8,26:Beersheba:swordsman:10
*9,26:Bezer:swordsman:10
