0
#
#!A
#
#
#
#
#
#
#
#
#
#
#
#
#
#
#
#
*1,1:Hasanlu:summoner|300,archer|100,giant bat|100:10

*21,1:Batroun:summoner|300,archer|100,giant bat|100:10

*4,4:Para:giant bat|100:10

*13,4:Bet Shemesh::10

*16,9:Tell Arpachiyah::10

*5,12:Beycesultan::10

*13,14:Shekhna::10

