0
#
#!A
#
#
#
#
#
#
#
#
#
#
#
#
#
#
#
#
#
#
#
#
#
#
#
#
#
#
#
#
#
*1,1:Hasanlu:summoner|300,archer|100,giant bat|100:10

*35,1:Batroun:summoner|300,archer|100,giant bat|100:10

*18,4:Para:giant bat|100:10

*27,4:Bet Shemesh::10

*30,9:Tell Arpachiyah::10

*19,12:Beycesultan::10

*27,14:Shekhna::10

