0
#
#A
#
#
#
#
#
#
#
#
#
#
#
#
#
#
#!
#
*21,1:Qumran:swordsman,archer:10

*1,2:Bet-el:ogre:10

*12,2:Dur-Kurigalzu:dragon:10

*21,7:Masat Hoyuk:archer:10

*1,10:Tepe Gawra:archer:10

*11,15:Qatara:dragon:10

*21,15:Bezer:ogre:10

*1,16:Shibaniba:swordsman,archer:10

