0
#
#!A
#
#
#
#
#
#
#
#
#
#
#
#
#
#
#
#
#
#
#
#
#
#
#
#
#
#
#
#
#
#
#
#
#
#
#
#
#
#
#
#
#
#
#
#
#
#
*1,1:Hasanlu:summoner|300,archer|100,giant bat|100:10

*66,1:Batroun:summoner|300,archer|100,giant bat|100:10

*49,4:Para:giant bat|100:10

*58,4:Bet Shemesh::10

*61,9:Tell Arpachiyah::10

*8,11:Qumran:ogre|100,summoner|3:10
*50,12:Beycesultan::10

*58,14:Shekhna::10

